21111111111111111111111111111112
10000000000000000000000000000001
10000000000000000000000000000001
10000000000000000000000000000001
10000000000000000000000000000001
10000000000000000000000000000001
10000000000000000000000000000001
10000000000000111100000000000001
10000000000000122100000000000001
10000000000000122100000000000001
10000000000000122100000000000001
10000000000000122100000000000001
10000000000000122100000000000001
10000001111111222211111110000001
10000001222222222222222210000001
10000001222222222222222210000001
10000001111111222211111110000001
10000000000000122100000000000001
10000000000000122100000000000001
10000000000000122100000000000001
10000000000000122100000000000001
10000000000000122100000000000001
10000000000000111100000000000001
10000000000000000000000000000001
10000000000000000000000000000001
10000000000000000000000000000001
10000000000000000000000000000001
10000000000000000000000000000001
10000000000000000000000000000001
10000000000000000000000000000001
10000000000000000000000000000001
21111111111111111111111111111112