21111111111111112222222222222222
10000000000000001222222222222222
10000000000000000122222222222222
10000000000000000012222222222222
10000000000000000001222222222222
10000000000000000000122222222222
10000000000000000000012222222222
10000000000000000000001222222222
10000000000000000000000122222222
10000000000000000000000012222222
10000000000000000000000001222222
10000000000000000000000000122222
10000000000000000000000000012222
10000000000000000000000000001222
10000000000000000000000000000122
10000000000000000000000000000012
11000000000000344440000000000001
22100000000000000000000000000001
22210000000000000000000000000001
22221000000000000000000000000001
22222100000000000000000000000001
22222210000000000000000000000001
22222221000000000000000000000001
22222222100000000000000000000001
22222222210000000000000000000001
22222222221000000000000000000001
22222222222100000000000000000001
22222222222210000000000000000001
22222222222221000000000000000001
22222222222222100000000000000001
22222222222222210000000000000001
22222222222222221111111111111112