21111111111111111111111111111112
10000000000000000000000000000001
10000000000000000000000000000001
10000000000000000000000000000001
10000000000000000000000000000001
10000000000000000000000000000001
10000000000000000000000000000001
10000000211111111111111200000001
10000000100000000000000100000001
10000000100000000000000100000001
10000000100000000000000100000001
10000000100000000000000100000001
10000000100000000000000100000001
10000000100000000000000100000001
10000000100000000000000100000001
10000000100000000000000100000001
10000000100000344440000100000001
10000000100000000000000100000001
10000000100000000000000100000001
10000000100000000000000100000001
10000000100000000000000100000001
10000000100000000000000100000001
10000000211111111111111200000001
10000000000000000000000000000001
10000000000000000000000000000001
10000000000000000000000000000001
10000000000000000000000000000001
10000000000000000000000000000001
10000000000000000000000000000001
10000000000000000000000000000001
10000000000000000000000000000001
21111111111111111111111111111112